60
4
4002022020001
0111212101110
2100000000011
2101110111011
0001020201220
2121210101010
2122020200001
0121010121111
0100020202021
0111212121210
0210200300001
1002100000200
./../resources/maps/1Ground
./../resources/maps/1Wall