60
4
4022222222203
0121212121210
2222222222222
2121212121212
2222222222222
2121212121212
2222222222222
2121212121212
2222222222222
0121212121210
3022222222203
./../resources/maps/1Ground
./../resources/maps/1Wall