60
4
..000000000..
.10101010101.
0000000000000
0101010101010
0000000000000
0101010101010
0000000000000
0101010101010
0000000000000
.10101010101.
..000000000..
./resources/maps/1Ground
./resources/maps/1Wall