60
4
4000000000003
0101010101010
0000000000000
0101010101010
0000000000000
0101010101010
0000000000000
0101010101010
0000000000000
0101010101010
3000000000003
./../resources/maps/1Ground
./../resources/maps/1Wall